11111111K1111
1001000000CC1
1000011111001
1P00011E00001
1111111111111