111111111111111111111111111111
10011111C011C001000C0100001111
100000000001110100100001100011
110111011C00010000001101C01011
110000000000C000101110011000C1
1C1011011111000010000010111111
1100000000C0001101110C0001C001
111001111111000000111110111001
10001100C000000100C00000000001
110100010111110001011110100101
11010111010100000000000011C1C1
110100001101011110001100100111
1C0000001001110000111011100C11
110101100000C000101C0000101111
1C0101011111110110110111101001
111101000100010C000100C1000001
10000100E011011110010111011001
1001100100C100000101000000C011
1010100001011011000C1111111111
10C000C00100C01C00010C00000011
1110011101110P0100011011110001
1010111C00100011001101C1C00011
101000110110010011001000111101
1000100C0101111000000011010111
10C01101110000C0101000000000C1
111111111111111111111111111111