1111111111111
1101000000CC1
1000011111001
1P000111E0001
1111111111111