1111111111111111111111111111111111
1E00EEEEEEE0000C00000C000000000001
101001010010000010EEEEEEEEEE010101
1010010CCCCCCCCCEEÈC00000001010111
1P0000000C00C0000ECCCCCCCCCCCE00C1
1111111111111111111111111111111111