1111111111111
1101000000CC1
1000011111001
1P00011E00011
1111111111111