1111111111111
1C00C0C0C00C1
1C0C011111001
10CP11E0C0C01
100C11C0C0001
1111111111111