1111111111111
1C000000000C1
1000011111001
100P11E000001
1111111111111