1111111111111
100100CC00001
10E0011111001
1P001100CCC01
1111111111111