1111111111111
10000100E0C01
1000010111001
1P00110000001
1111111111111