1111111111111
1000010EE00C1
1000010111001
1P0011E000001
1111111111111