1111111111111111111111111111111111
10000CCCCCCCC00000E00000000CC00001
1010010100100C00101001000000010101
1010010010101010001001000000010101
10P000000000000CCCCCC000000C000001
1111111111111111111111111111111111
